###################
#....#...O...#....#
#O##.#.#####.#.##O#
#.................#
##.#.###.#.###.#.##
##.#.###.#.###.#.##
--.#.....#.....#.--
##.### ##### ###.##
##.-------------.##
##.###-##&##-###.##
##.#---#GGG#---#.##
##.#-#-#####-#-#.##
--.--#-------#--.--
##.#####-#-#####.##
##.....--#--.....##
##.###.#####.###.##
#........P........#
#.##.###.#.###.##.#
#.##.#...#...#.##.#
#O##.#.#####.#.##O#
#........O........#
###################